Postcode,Total,Passenger Vehicles,Off-road Vechicles,People movers,Small Buses,Mobile Homes,Motorcycles,Scooters,Light Trucks,Light Plants,Light Trailers,Other Vehicles,All Light,Buses,Heavy Trucks,Prime Movers,Heavy Plants,Heavy Trailers,All Heavy
2000,20566,11879,4207,217,97,28,584,85,2643,3,556,3,20302,54,159,8,17,26,264
2006,148,20,60,0,4,0,0,0,27,3,30,0,144,0,4,0,0,0,4
2007,2892,1756,521,37,11,10,176,17,287,5,49,0,2869,7,13,0,2,1,23
2008,3333,2010,554,35,25,10,219,42,261,1,154,0,3311,7,13,1,0,1,22
2009,6819,4364,1273,39,16,11,379,53,496,0,140,0,6771,7,37,0,0,4,48
2010,11384,7325,2047,75,34,24,781,143,712,1,208,0,11350,8,21,1,1,3,34
2011,9902,6883,1833,37,13,6,476,121,372,1,153,0,9895,1,6,0,0,0,7
2015,11718,5895,2074,67,25,5,972,63,2012,0,254,0,11367,42,249,12,1,47,351
2016,6066,3568,1164,44,85,10,401,84,448,0,216,0,6020,6,39,0,1,0,46
2017,13732,8568,2581,80,26,12,1067,85,962,1,185,0,13567,9,142,4,3,7,165
2018,10984,6694,2192,113,11,18,586,57,884,0,321,0,10876,14,90,2,0,2,108
2019,13613,5736,2833,101,47,47,502,47,2396,2,674,0,12385,205,436,178,8,401,1228
2020,27527,17435,5709,159,139,21,678,42,2545,3,354,0,27085,21,240,57,3,121,442
2021,8421,5537,1693,33,8,14,399,101,400,5,218,0,8408,1,12,0,0,0,13
2022,7698,4487,1653,71,15,7,454,87,563,1,201,0,7539,111,46,0,0,2,159
2023,6560,4411,1282,40,14,4,299,67,276,0,150,0,6543,2,7,3,0,5,17
2024,6669,3637,1671,52,14,8,490,116,434,0,231,0,6653,5,10,0,0,1,16
2025,4322,2995,804,19,10,2,153,53,176,0,99,0,4311,6,3,0,2,0,11
2026,18568,9992,4290,171,43,26,1847,425,1278,0,463,0,18535,1,29,2,0,1,33
2027,5128,3677,847,21,3,5,202,45,210,0,110,0,5120,0,6,0,1,1,8
2028,3271,2177,612,6,9,2,116,15,203,0,104,0,3244,0,25,1,0,1,27
2029,6350,4085,1254,48,8,7,341,59,353,0,187,0,6342,2,6,0,0,0,8
2030,10290,6593,2110,57,6,4,506,82,548,0,367,0,10273,1,15,0,0,1,17
2031,18797,11318,4004,136,34,22,1105,233,1248,0,535,0,18635,88,71,2,1,0,162
2032,7240,4398,1560,100,12,10,362,41,487,0,230,0,7200,5,29,2,1,3,40
2033,5722,3622,1146,60,14,8,280,51,341,0,176,0,5698,1,7,4,0,12,24
2034,11984,7093,2617,88,16,16,810,170,780,1,364,0,11955,2,24,1,1,1,29
2035,21469,12173,4934,260,41,54,1242,180,1603,1,897,0,21385,2,79,1,1,1,84
2036,23376,12022,5243,227,49,51,1042,92,2303,0,1310,0,22339,118,220,157,13,529,1037
2037,8253,5337,1519,53,7,15,648,63,409,0,183,1,8235,4,10,1,0,3,18
2038,5491,3411,1074,39,6,10,298,41,380,0,200,0,5459,0,9,0,0,23,32
2039,6131,3525,1304,32,8,4,259,53,529,0,351,0,6065,0,59,0,6,1,66
2040,14754,8312,3303,113,35,24,670,106,1220,1,532,0,14316,317,100,6,3,12,438
2041,9494,5898,2133,58,10,14,365,64,534,0,386,0,9462,0,26,3,0,3,32
2042,8281,5266,1561,67,20,15,574,71,480,0,210,0,8264,3,14,0,0,0,17
2043,4431,2893,828,22,8,7,292,48,236,0,82,0,4416,0,4,3,1,7,15
2044,6558,3529,1310,51,5,14,330,38,751,1,244,0,6273,104,107,12,1,61,285
2045,5221,2981,1172,38,13,5,317,32,377,0,274,0,5209,3,8,0,1,0,12
2046,19669,12067,3977,111,21,23,807,110,1404,2,1030,0,19552,4,80,5,2,26,117
2047,8089,5033,1709,56,4,10,286,41,503,0,418,0,8060,3,25,0,0,1,29
2048,4076,2584,800,27,9,9,184,21,316,0,120,0,4070,1,5,0,0,0,6
2049,6779,4216,1364,43,24,15,348,53,419,5,211,0,6698,4,68,4,1,4,81
2050,4590,3046,796,21,21,4,275,38,299,2,67,0,4569,5,15,0,0,1,21
2052,28,15,3,0,0,0,3,1,3,0,2,0,27,1,0,0,0,0,1
2060,11211,6747,2228,60,20,15,393,35,1098,0,397,3,10996,5,89,5,2,114,215
2061,3404,2507,552,14,4,3,114,14,112,0,80,0,3400,1,3,0,0,0,4
2062,4405,2865,968,18,4,4,180,33,185,0,144,0,4401,0,4,0,0,0,4
2063,4361,2730,1067,25,3,1,117,23,166,0,216,0,4348,0,13,0,0,0,13
2064,8393,4565,1884,73,17,16,156,23,1153,1,407,0,8295,1,85,1,0,11,98
2065,20699,12624,4688,121,32,20,763,58,1725,1,575,1,20608,11,72,1,1,6,91
2066,22328,13704,4936,200,22,27,846,71,1403,1,991,1,22202,4,110,0,0,12,126
2067,16038,9659,3695,230,44,26,408,19,1250,0,468,0,15799,9,220,4,2,4,239
2068,11094,6755,2655,121,10,17,324,36,524,0,518,0,10960,114,18,2,0,0,134
2069,9760,6014,2302,104,2,10,258,27,490,0,531,0,9738,3,17,0,0,2,22
2070,9387,5894,2250,125,7,14,212,14,413,1,427,0,9357,0,28,0,1,1,30
2071,8877,5874,2024,126,6,10,196,14,294,0,322,0,8866,1,7,0,0,3,11
2072,5701,3610,1371,74,17,7,110,5,262,0,211,0,5667,3,31,0,0,0,34
2073,12794,7632,3115,162,34,4,309,20,691,0,704,1,12672,1,96,14,1,10,122
2074,16575,10147,3888,164,14,20,459,19,672,0,1161,0,16544,8,18,4,0,1,31
2075,15302,9496,3520,176,14,22,516,23,659,1,843,0,15270,1,31,0,0,0,32
2076,16962,10203,4105,212,29,24,446,23,733,0,1117,0,16892,39,29,1,0,1,70
2077,26054,15039,6023,308,31,48,894,34,1803,0,1766,0,25946,6,93,3,1,5,108
2079,6128,3153,1381,59,8,6,240,10,490,0,756,0,6103,0,23,0,1,1,25
2080,2332,778,665,14,3,4,53,1,314,0,302,0,2134,93,69,2,19,15,198
2081,4463,2156,1064,37,8,6,184,5,326,0,657,0,4443,0,18,0,0,2,20
2082,4591,2085,1138,46,6,13,184,7,373,1,725,0,4578,0,12,1,0,0,13
2083,1677,654,356,11,3,8,61,3,202,0,368,0,1666,0,11,0,0,0,11
2084,4845,1674,1103,39,13,12,168,9,592,3,846,0,4459,189,100,15,3,79,386
2085,10106,5141,2395,106,31,15,315,21,881,1,1087,0,9993,6,77,2,1,27,113
2086,11230,5656,2811,132,20,25,508,20,960,0,1063,0,11195,3,31,0,0,1,35
2087,9716,5240,2372,130,21,12,336,20,631,0,926,0,9688,1,27,0,0,0,28
2088,19425,12676,4275,104,28,22,642,169,777,1,703,0,19397,8,20,0,0,0,28
2089,7043,4601,1416,30,8,8,309,49,359,0,194,0,6974,54,14,0,0,1,69
2090,8156,5525,1646,56,8,11,347,51,302,0,198,1,8145,3,5,2,0,1,11
2092,5232,2857,1365,62,2,11,217,27,322,1,357,0,5221,0,11,0,0,0,11
2093,16433,8629,4371,189,25,19,894,124,1065,0,1067,0,16383,1,45,1,3,0,50
2094,4066,2247,1023,49,4,13,242,57,247,0,183,0,4065,0,0,0,1,0,1
2095,10425,5570,2662,104,43,25,659,127,745,0,461,1,10397,2,21,0,4,1,28
2096,10743,5165,2838,151,24,35,680,111,1009,0,705,0,10718,6,19,0,0,0,25
2097,12244,5908,3220,109,21,30,529,47,1182,1,1157,0,12204,1,37,0,1,1,40
2099,31005,15492,7630,338,81,58,1656,170,3163,1,2152,0,30741,17,228,2,6,11,264
2100,20678,9241,5044,286,151,45,922,83,2620,8,1682,3,20085,318,253,3,5,14,593
2101,17035,7363,4272,165,26,51,781,63,1955,1,2138,0,16815,6,168,7,9,30,220
2102,7288,3223,1918,63,10,16,290,11,968,0,700,0,7199,1,79,0,2,7,89
2103,10356,4781,2492,102,15,25,384,32,1165,0,1194,1,10191,47,110,2,1,5,165
2104,3713,1828,816,19,4,11,169,16,277,0,545,0,3685,1,24,1,1,1,28
2105,1887,865,461,16,2,6,100,8,174,0,252,0,1884,0,3,0,0,0,3
2106,8569,4017,2191,77,19,28,380,29,835,0,959,0,8535,0,34,0,0,0,34
2107,13805,6316,3604,194,21,41,538,75,1316,1,1616,0,13722,1,66,3,1,12,83
2108,1719,974,372,14,5,3,62,14,116,0,152,0,1712,0,7,0,0,0,7
2109,66,13,21,1,3,0,0,0,15,3,10,0,66,0,0,0,0,0,0
2110,6989,4430,1391,58,21,5,198,20,410,2,421,0,6956,6,20,2,0,5,33
2111,12173,7044,2474,80,42,16,399,40,1102,0,692,0,11889,186,88,4,1,5,284
2112,24589,15063,5204,213,60,33,679,36,1712,2,1267,0,24269,157,125,10,4,24,320
2113,21499,12682,4604,211,58,19,533,23,2153,0,932,0,21215,6,158,7,0,113,284
2114,15698,9655,3347,199,21,25,414,22,1161,1,741,0,15586,1,100,6,2,3,112
2115,8282,4749,1878,109,14,15,230,10,710,1,518,0,8234,2,38,3,1,4,48
2116,8712,3532,2127,97,15,13,185,3,1874,5,665,0,8516,0,179,4,5,8,196
2117,14311,8362,3253,196,52,34,374,21,1163,0,801,2,14258,2,47,3,0,1,53
2118,17574,10724,4099,339,30,41,332,15,1145,0,788,0,17513,2,39,2,0,18,61
2119,8317,5094,1984,95,11,13,194,10,387,0,510,0,8298,1,18,0,0,0,19
2120,15594,9004,3633,189,23,23,388,12,1056,3,1147,0,15478,2,106,0,5,3,116
2121,19752,12481,4619,335,39,28,422,26,904,2,853,0,19709,2,32,3,1,5,43
2122,18409,11859,4088,297,39,30,445,21,955,1,625,1,18361,1,45,0,1,1,48
2125,12694,7571,2986,152,15,21,342,7,694,2,884,1,12675,3,14,0,0,2,19
2126,12711,7888,3019,221,24,31,325,7,542,1,628,0,12686,4,19,0,0,2,25
2127,15622,9223,3347,107,51,22,437,16,1556,4,572,1,15336,11,179,14,6,76,286
2128,6082,1999,1347,50,43,2,74,6,1718,3,359,0,5601,63,302,42,6,68,481
2129,374,62,120,3,0,0,1,2,96,3,14,0,301,0,61,6,1,5,73
2130,3968,2623,749,41,5,2,149,18,231,0,119,0,3937,2,10,6,0,13,31
2131,11084,7363,2184,105,26,25,405,43,614,0,294,0,11059,2,19,0,1,3,25
2132,6537,3969,1475,91,21,11,188,19,449,1,281,0,6505,7,23,1,0,1,32
2133,7166,4232,1565,73,12,6,186,19,627,1,380,0,7101,0,55,2,2,6,65
2134,9206,5451,1747,129,30,19,256,13,934,3,293,0,8875,98,218,5,1,9,331
2135,14684,9255,2808,192,59,27,387,18,1343,0,406,0,14495,12,103,18,0,56,189
2136,6866,3381,1315,80,18,13,135,10,765,0,275,0,5992,6,345,123,9,391,874
2137,20643,12185,4288,177,17,29,617,83,2019,0,1040,0,20455,4,150,8,2,24,188
2138,11362,6899,2576,99,21,15,315,17,863,0,483,0,11288,1,56,1,2,14,74
2139,2,1,0,0,0,0,0,0,1,0,0,0,2,0,0,0,0,0,0
2140,12909,7345,2721,127,21,28,386,30,1720,1,286,0,12665,4,182,18,0,40,244
2141,21050,12010,4715,333,91,43,334,14,2484,0,567,3,20594,13,296,14,5,128,456
2142,18855,10703,3889,238,74,43,391,18,2260,1,732,0,18349,14,356,41,6,89,506
2143,7438,3794,1645,102,17,16,96,7,1024,17,374,0,7092,4,276,12,7,47,346
2144,24419,14049,4947,395,52,79,552,90,2638,0,732,0,23534,9,543,119,14,200,885
2145,55493,31542,12169,493,169,92,1218,32,5107,4,3410,0,54236,34,843,172,7,201,1257
2146,12070,7158,2608,110,23,25,305,7,869,0,882,0,11987,3,64,12,1,3,83
2147,33535,14934,6810,281,42,57,954,12,4339,5,5013,0,32447,242,561,82,29,174,1088
2148,51535,26607,10360,504,151,96,1351,20,6028,8,3973,0,49098,33,1490,302,37,575,2437
2150,24423,13782,5594,156,134,16,493,24,3058,9,830,0,24096,38,222,14,36,17,327
2151,14959,8582,3273,178,56,33,341,3,1485,1,871,0,14823,28,101,0,1,6,136
2152,8418,4713,1718,89,25,20,233,5,755,0,563,0,8121,196,50,15,4,32,297
2153,48772,26334,11402,486,129,65,1297,28,4456,0,3961,0,48158,23,372,78,2,139,614
2154,31769,17712,7565,336,117,43,789,23,2843,0,2156,0,31584,12,136,12,1,24,185
2155,51449,28912,12912,502,63,59,1517,26,3753,0,3243,0,50987,11,324,55,11,61,462
2156,14586,6393,3011,94,16,24,532,8,1621,2,2566,0,14267,4,255,10,6,44,319
2157,5097,1607,1135,29,11,10,229,1,703,0,1118,0,4843,0,209,8,1,36,254
2158,9409,4254,1903,88,20,21,331,13,1083,1,1329,0,9043,184,161,2,5,14,366
2159,6224,2181,1377,39,11,8,288,7,709,0,1460,1,6081,2,112,4,0,25,143
2160,23450,13512,5378,256,94,44,376,17,2268,1,1157,0,23103,5,252,32,6,52,347
2161,23784,11595,5517,301,84,58,330,15,2783,16,1988,1,22688,7,691,122,32,244,1096
2162,12647,6823,3022,201,72,38,221,17,1228,0,743,0,12365,7,190,23,8,54,282
2163,7163,3836,1495,131,29,13,165,6,728,0,369,0,6772,3,129,36,1,222,391
2164,27844,10209,5112,220,74,38,613,8,5715,6,1921,2,23918,124,2071,572,86,1073,3926
2165,26211,15193,6093,439,114,72,389,19,2206,0,1172,0,25697,5,355,58,4,92,514
2166,32852,19172,7631,596,100,114,502,17,2917,3,1390,2,32444,9,343,28,6,22,408
2167,6204,3588,1505,72,18,8,184,3,414,0,382,0,6174,7,18,2,0,3,30
2168,28364,15952,6523,435,99,104,564,15,2432,1,1893,1,28019,9,220,66,4,46,345
2170,91582,45824,18788,935,288,210,2027,28,10835,8,8303,0,87246,48,2094,608,48,1538,4336
2171,29476,16011,6581,278,71,70,681,9,3067,0,1880,0,28648,144,424,99,8,153,828
2172,2076,982,451,10,2,11,114,1,224,0,266,0,2061,1,13,0,1,0,15
2173,9517,5182,2189,103,15,18,392,5,778,0,786,0,9468,3,33,4,0,9,49
2174,7077,4276,1774,82,12,12,176,4,488,0,176,0,7000,0,42,24,0,11,77
2175,2609,678,377,9,12,5,55,1,511,0,398,0,2046,1,365,76,5,116,563
2176,34567,20028,7595,401,106,82,588,20,3124,0,1937,1,33882,10,505,87,2,81,685
2177,11076,6588,2481,156,31,39,242,5,865,0,509,0,10916,9,101,33,0,17,160
2178,4396,1538,748,27,7,2,123,2,757,0,662,2,3868,3,274,76,21,154,528
2179,12565,6513,2766,100,46,21,340,10,1297,0,940,0,12033,16,255,73,4,184,532
2190,24183,11274,4861,353,167,44,1253,20,3118,19,1620,1,22730,14,949,83,85,322,1453
2191,4162,2400,914,52,10,7,68,4,467,0,193,0,4115,0,36,4,0,7,47
2192,8677,5315,1811,91,22,21,186,9,787,1,348,0,8591,3,70,3,1,9,86
2193,10535,6543,2172,124,16,21,375,27,796,0,411,1,10486,0,40,2,0,7,49
2194,13338,8392,2739,220,31,71,368,22,1142,0,245,0,13230,1,84,6,6,11,108
2195,12909,8309,2535,281,50,41,505,31,737,0,323,1,12813,8,71,4,3,10,96
2196,21776,12559,4791,335,76,60,487,20,2018,0,1064,1,21411,8,275,30,6,46,365
2197,6615,3628,1546,82,29,23,123,5,611,2,482,0,6531,2,70,7,2,3,84
2198,6622,3450,1530,74,20,19,126,6,689,0,573,0,6487,8,74,19,5,29,135
2199,12343,6850,2899,199,49,40,232,7,1129,0,723,0,12128,1,163,7,3,41,215
2200,32032,17928,7149,368,150,100,516,18,3413,4,1434,0,31080,352,475,39,5,81,952
2203,7661,4943,1531,74,8,12,313,30,470,0,263,1,7645,1,12,1,0,2,16
2204,16160,9615,3138,146,34,24,681,83,1780,1,464,0,15966,9,156,8,1,20,194
2205,14248,8690,2899,142,27,38,532,52,1178,0,437,0,13995,66,169,5,2,11,253
2206,13214,7831,2798,115,18,30,413,52,1121,0,725,3,13106,3,61,21,5,18,108
2207,18760,11052,3950,218,71,37,558,50,1545,1,996,0,18478,11,192,14,1,64,282
2208,10253,5444,2144,99,39,22,271,14,1369,0,488,1,9891,135,198,12,0,17,362
2209,10499,6445,2242,153,17,20,252,12,832,1,465,0,10439,3,42,2,1,12,60
2210,24028,13104,5104,301,53,48,546,18,2693,1,1708,0,23576,86,311,17,4,34,452
2211,13859,7123,3046,138,16,27,368,11,1576,3,1082,0,13390,3,233,63,15,155,469
2212,14854,8229,2894,136,59,40,315,20,1748,0,967,0,14408,10,254,49,8,125,446
2213,16705,9050,3667,157,24,19,499,11,1472,0,1676,0,16575,4,92,8,0,26,130
2214,4666,1924,929,34,3,8,109,5,781,0,514,0,4307,6,142,47,2,162,359
2216,17182,10019,3545,162,32,31,636,48,1623,5,798,0,16899,3,189,29,6,56,283
2217,17330,10511,3660,146,34,35,573,38,1366,2,801,0,17166,8,114,22,0,20,164
2218,9417,5738,1993,115,14,16,275,14,751,1,429,0,9346,1,53,8,0,9,71
2219,10330,5939,2062,60,16,23,343,17,890,0,810,0,10160,1,94,33,0,42,170
2220,17050,10643,3839,265,36,45,381,23,1087,0,599,0,16918,35,55,15,1,26,132
2221,12405,7258,2690,130,16,26,286,8,1017,0,848,0,12279,15,77,10,3,21,126
2222,6934,4396,1464,87,13,12,188,7,429,0,316,0,6912,2,16,2,0,2,22
2223,14856,8513,3227,128,22,17,377,14,1254,1,1085,0,14638,13,161,15,2,27,218
2224,12098,6567,2701,98,10,20,346,17,1064,0,1206,0,12029,2,52,9,1,5,69
2225,4563,2140,1101,31,6,12,162,8,415,0,669,0,4544,0,15,2,0,2,19
2226,9420,4676,2376,74,15,26,321,15,760,0,1120,0,9383,1,25,5,0,6,37
2227,11762,5623,3034,75,8,20,394,17,1146,0,1383,0,11700,10,51,0,0,1,62
2228,15553,7888,3772,110,23,38,528,32,1513,0,1471,0,15375,1,118,17,0,42,178
2229,28901,13094,6919,199,69,57,1053,81,3871,3,3080,0,28426,21,369,25,1,59,475
2230,25142,12128,6011,153,51,82,1116,126,2664,2,2671,0,25004,10,104,6,2,16,138
2231,3041,857,682,21,7,10,152,7,513,0,581,0,2830,0,132,23,3,53,211
2232,29744,14276,6991,211,62,63,1228,34,3285,1,3234,0,29385,6,315,7,2,29,359
2233,25224,11440,6075,173,38,57,941,28,2596,2,3720,0,25070,11,113,9,1,20,154
2234,26759,13686,6019,162,23,38,943,15,2510,1,3107,0,26504,16,166,34,1,38,255
2250,69954,30955,14657,508,258,145,2937,79,8833,5,9126,3,67506,48,1489,272,22,617,2448
2251,30997,13655,7229,235,73,115,1204,58,3369,0,4744,0,30682,115,173,8,2,17,315
2256,12867,6172,2821,122,27,46,508,27,1202,1,1836,0,12762,10,78,1,1,15,105
2257,25891,11686,5914,216,91,88,992,51,2754,0,3936,3,25731,6,129,12,2,11,160
2258,6025,2175,1303,28,21,12,312,3,818,2,1189,1,5864,7,113,15,0,26,161
2259,68305,26820,13870,419,245,222,3146,48,9083,6,12185,1,66045,121,1134,287,33,685,2260
2260,23077,10350,5677,179,38,64,963,99,2579,0,2956,2,22907,8,141,6,2,13,170
2261,49850,21671,11243,371,223,160,1937,69,6201,2,7322,1,49200,125,417,35,8,65,650
2262,19463,8591,4014,105,65,60,909,22,2363,0,3183,0,19312,7,108,13,2,21,151
2263,21966,9781,4506,175,63,79,951,29,2691,1,3512,0,21788,16,132,13,2,15,178
2264,18797,6638,3652,111,49,91,885,20,2521,1,4416,1,18385,54,256,30,7,65,412
2265,8214,2914,1722,57,13,26,424,9,1046,1,1814,0,8026,6,135,15,0,32,188
2267,3400,1253,750,12,13,23,118,5,348,0,855,0,3377,2,21,0,0,0,23
2278,3441,947,700,12,16,12,258,1,515,0,912,0,3373,0,58,2,0,8,68
2280,26895,10553,6350,122,48,101,1067,27,3063,1,5412,0,26744,13,106,11,2,19,151
2281,15729,5828,3580,92,45,84,594,17,1881,1,3482,1,15605,1,89,13,0,21,124
2282,16720,7017,3787,85,27,57,684,18,1861,0,3029,0,16565,3,119,12,2,19,155
2283,26616,9969,5564,150,82,115,1180,34,3006,1,6094,1,26196,47,259,33,3,78,420
2284,13415,5029,2937,65,59,40,637,14,1684,16,2625,0,13106,6,241,9,16,37,309
2285,34128,13933,7664,196,110,79,1621,31,4642,0,5154,0,33430,73,484,52,7,82,698
2286,5162,1792,1073,23,24,13,369,2,656,0,1169,0,5121,5,33,0,1,2,41
2287,35443,16629,7726,205,82,79,1603,40,3674,11,4978,0,35027,8,239,64,3,102,416
2289,16900,7776,4150,151,43,41,707,42,1802,1,2075,0,16788,0,99,6,0,7,112
2290,32640,13604,7850,254,98,107,1335,53,3971,2,4987,0,32261,13,318,13,12,23,379
2291,12002,5422,3112,108,53,45,622,90,1207,0,1299,2,11960,2,37,1,0,2,42
2292,3404,1323,855,25,16,9,104,13,654,0,295,0,3294,1,88,5,7,9,110
2293,3388,1599,736,25,9,13,165,13,526,0,266,0,3352,0,30,2,0,4,36
2294,2372,806,498,13,7,13,102,11,452,0,239,1,2142,0,109,35,6,80,230
2295,7206,2891,1729,45,10,31,292,13,862,0,1300,0,7173,1,25,4,0,3,33
2296,1915,921,403,22,18,4,187,6,245,0,99,0,1905,1,7,1,0,1,10
2297,1673,691,410,16,4,4,65,6,281,2,179,0,1658,1,12,0,1,1,15
2298,8046,3707,1714,61,32,18,340,18,1070,2,893,0,7855,16,140,2,12,21,191
2299,9899,5021,2165,119,91,22,344,21,1040,0,986,0,9809,1,75,5,2,7,90
2300,11386,5897,2493,154,122,38,469,60,1193,3,820,0,11249,6,115,1,2,13,137
2302,1670,888,392,8,13,3,53,3,212,0,92,0,1664,1,4,1,0,0,6
2303,8312,4042,1958,90,23,31,309,44,962,0,625,0,8084,182,32,7,5,2,228
2304,16474,6372,3735,133,72,34,1127,20,2522,2,1523,0,15540,4,501,183,8,238,934
2305,11389,5592,2863,105,26,24,402,27,1036,0,1273,0,11348,7,30,1,0,3,41
2306,2105,975,434,26,9,4,117,2,200,0,335,0,2102,1,2,0,0,0,3
2307,3759,1847,808,27,11,6,156,3,358,0,532,0,3748,1,8,0,0,2,11
2308,284,149,61,3,1,0,6,0,32,2,27,0,281,1,2,0,0,0,3
2311,1454,256,350,4,2,3,60,0,249,0,444,0,1368,27,46,3,0,10,86
2312,2346,458,503,6,7,9,112,1,389,1,774,0,2260,4,69,2,0,11,86
2314,17,4,4,0,0,0,0,0,4,0,4,0,16,0,1,0,0,0,1
2315,15297,6256,3757,77,39,71,554,34,1584,1,2828,1,15202,12,68,6,0,9,95
2316,8056,2617,1965,42,19,29,292,19,1039,0,1820,0,7842,87,95,9,2,21,214
2317,7030,2795,1691,28,25,33,240,10,783,0,1349,0,6954,3,67,1,0,5,76
2318,16759,5131,3464,88,37,43,898,14,2220,1,4426,0,16322,25,237,49,4,122,437
2319,7765,2628,1601,33,22,41,370,9,955,0,2049,0,7708,2,35,10,1,9,57
2320,43330,15117,9558,181,123,90,2018,32,6268,3,8582,0,41972,29,727,183,24,395,1358
2321,22477,7437,4882,76,54,63,1176,6,3181,2,5193,2,22072,2,262,43,3,95,405
2322,31291,9615,6577,131,69,48,1136,21,5430,1,5388,0,28416,173,1079,567,56,1000,2875
2323,25808,10689,5403,139,65,73,1175,20,3053,1,4878,1,25497,23,214,18,0,56,311
2324,30064,9462,6264,143,88,124,1324,14,4131,1,7446,0,28997,47,552,150,6,312,1067
2325,32430,10309,6938,153,126,68,1824,30,4697,3,7713,1,31862,92,351,38,18,69,568
2326,9327,2909,1773,37,28,20,551,7,1394,1,2410,1,9131,2,137,21,0,36,196
2327,8653,3084,1809,36,27,20,452,3,1168,0,1781,0,8380,7,164,30,14,58,273
2328,3117,702,734,12,2,5,177,0,573,0,812,0,3017,5,70,8,0,17,100
2329,3157,481,787,6,7,3,101,0,573,2,947,0,2907,2,143,26,4,75,250
2330,30780,7195,7077,101,109,42,1474,16,6005,3,6904,1,28927,83,970,240,43,517,1853
2333,16923,4496,3745,56,34,32,881,9,3021,14,3772,0,16060,54,496,60,48,205,863
2334,4062,1172,829,14,11,9,259,3,624,0,1067,0,3988,2,39,7,0,26,74
2335,10252,2801,2130,29,17,21,631,9,1660,1,2661,0,9960,11,187,32,1,61,292
2336,3308,730,729,12,2,8,157,1,617,2,953,0,3211,2,75,3,0,17,97
2337,10787,2356,2530,21,20,13,369,5,1834,7,3023,0,10178,16,343,78,22,150,609
2338,1988,417,473,8,4,6,58,0,305,0,626,0,1897,24,47,5,0,15,91
2339,1378,186,353,2,3,1,40,0,200,0,404,0,1189,2,83,29,0,75,189
2340,59474,18262,12701,205,183,76,2196,34,9653,11,13095,2,56418,151,1467,446,19,973,3056
2341,1753,490,357,1,3,4,79,1,285,0,467,0,1687,0,27,12,0,27,66
2342,761,111,163,4,0,0,22,0,149,0,229,0,678,1,32,13,0,37,83
2343,7096,1405,1600,22,15,7,188,3,1218,8,1955,0,6421,2,289,108,14,262,675
2344,1127,170,248,0,3,2,23,0,210,0,380,0,1036,0,60,8,0,23,91
2345,1067,176,232,3,3,2,25,0,216,0,355,0,1012,0,38,4,0,13,55
2346,4124,888,849,9,7,7,114,1,788,0,1282,1,3946,13,104,14,0,47,178
2347,2564,463,635,6,7,7,78,1,451,0,769,1,2418,8,109,11,0,18,146
2350,26354,8558,5857,152,78,38,1122,33,4076,11,5634,1,25560,69,504,51,10,160,794
2351,50,37,4,0,0,0,1,0,3,0,4,0,49,1,0,0,0,0,1
2352,3647,875,779,10,6,6,157,2,626,1,1076,0,3538,1,83,10,1,14,109
2353,1679,317,327,2,3,0,74,1,306,0,588,0,1618,0,34,7,1,19,61
2354,5715,770,1371,16,12,6,172,4,1127,0,1566,0,5044,24,305,106,4,232,671
2355,1091,168,236,6,3,0,51,0,214,0,357,0,1035,0,47,3,0,6,56
2357,5531,1104,1293,25,14,9,162,1,961,2,1618,0,5189,20,198,40,2,82,342
2358,5146,1148,1107,17,11,9,178,5,980,2,1436,0,4893,12,160,19,8,54,253
2359,1225,167,279,4,4,4,33,0,224,0,425,1,1141,3,58,6,0,17,84
2360,18155,4181,3803,61,48,32,767,13,3281,6,5245,0,17437,14,474,58,13,159,718
2361,1219,200,287,3,6,4,40,1,247,2,380,0,1170,2,44,2,0,1,49
2365,4940,947,1164,9,8,3,128,2,936,1,1433,0,4631,13,192,34,0,70,309
2369,1154,207,218,5,4,6,44,0,255,0,367,0,1106,0,36,4,0,8,48
2370,10042,2236,2118,29,27,23,328,7,1737,2,2926,0,9433,33,393,44,7,132,609
2371,1731,281,389,3,6,8,62,1,363,1,538,0,1652,3,54,6,2,14,79
2372,6067,1213,1464,17,15,20,147,4,1181,3,1673,0,5737,16,215,18,11,70,330
2380,13906,2916,3182,42,29,21,463,5,2593,2,3656,0,12909,29,434,148,19,367,997
2381,2486,403,563,4,6,7,91,0,446,2,690,0,2212,1,102,53,2,116,274
2382,2091,306,554,5,4,2,68,1,383,0,619,0,1942,7,72,26,0,44,149
2386,591,57,161,0,3,0,7,0,105,0,153,0,486,4,25,26,0,50,105
2388,4205,549,1091,6,17,3,89,0,699,1,1141,0,3596,9,106,78,5,411,609
2390,11505,2128,2937,30,15,15,291,6,2023,1,3191,0,10637,27,379,118,3,341,868
2395,1124,193,249,4,2,1,38,1,218,1,346,0,1053,1,47,8,2,13,71
2396,1303,219,312,4,0,3,19,0,234,1,387,0,1179,5,46,22,0,51,124
2397,620,63,153,0,1,1,10,0,110,0,190,0,528,0,16,16,0,60,92
2399,975,95,233,1,3,2,23,0,180,0,305,0,842,2,33,22,0,76,133
2400,12137,2147,3336,37,43,8,264,8,2117,1,3033,1,10995,19,404,197,7,515,1142
2401,443,52,103,3,0,0,9,0,87,0,150,0,404,0,14,7,0,18,39
2402,2531,408,564,8,6,5,65,3,473,0,813,0,2345,8,71,25,0,82,186
2403,1008,148,271,2,2,0,18,0,157,0,314,0,912,1,67,10,0,18,96
2404,2668,473,607,11,10,5,66,1,507,4,802,0,2486,12,101,10,17,42,182
2405,578,54,179,0,3,1,13,0,116,0,144,0,510,0,9,16,0,43,68
2406,551,75,166,4,1,0,13,0,101,0,154,0,514,0,5,7,0,25,37
2408,451,28,139,0,0,1,10,0,77,0,96,0,351,0,22,26,0,52,100
2409,359,75,106,1,3,0,6,0,62,0,60,0,313,1,16,13,0,16,46
2410,229,34,72,0,2,0,3,0,45,0,57,0,213,0,8,2,0,6,16
2415,617,106,145,1,0,2,41,0,116,0,172,0,583,1,25,3,1,4,34
2420,5698,1287,1295,7,19,16,259,7,1024,1,1540,0,5455,20,174,13,4,32,243
2421,2937,601,664,3,4,5,147,2,526,0,887,0,2839,3,62,10,0,23,98
2422,8121,1751,1795,32,19,31,458,15,1303,3,2323,1,7731,17,202,45,3,123,390
2423,5524,1134,1179,30,13,25,227,3,841,1,1802,0,5255,23,130,31,1,84,269
2424,737,111,192,2,2,3,32,1,139,0,241,0,723,0,9,2,1,2,14
2425,3153,614,616,8,10,8,140,2,543,0,1066,0,3007,1,96,8,3,38,146
2426,1105,245,216,1,5,2,47,1,183,0,342,0,1042,0,48,5,0,10,63
2427,4451,1378,1039,9,5,25,150,5,536,0,1263,0,4410,2,27,3,0,9,41
2428,28562,9762,6476,185,96,161,907,55,3556,1,6854,0,28053,46,349,25,9,80,509
2429,13308,3194,3053,54,38,39,578,5,2070,2,3870,0,12903,16,231,61,3,94,405
2430,43743,13592,9285,281,160,188,1641,32,6115,6,11323,1,42624,94,770,63,34,158,1119
2431,6580,2029,1574,27,15,35,279,16,872,2,1626,1,6476,1,64,15,0,24,104
2439,5015,1361,1076,29,9,24,225,3,714,0,1458,0,4899,0,86,4,1,25,116
2440,27687,6852,6483,153,108,90,1119,13,4275,4,7242,0,26339,146,653,194,4,351,1348
2441,7249,1565,1619,19,24,26,332,2,1193,1,2242,0,7023,3,138,28,1,56,226
2443,11105,3350,2369,49,44,48,470,14,1497,0,3101,0,10942,36,103,5,4,15,163
2444,51948,20216,11633,292,175,205,2026,72,7057,8,8676,3,50363,103,785,315,26,356,1585
2445,8260,2794,1914,43,21,38,399,13,1071,0,1902,0,8195,2,54,4,0,5,65
2446,19346,4814,4246,78,39,55,999,8,3196,2,5150,0,18587,48,411,114,12,174,759
2447,10056,2564,2256,46,22,33,480,7,1535,1,2737,0,9681,39,234,26,7,69,375
2448,9721,3555,2238,55,35,50,375,7,1202,0,2094,0,9611,7,92,2,0,9,110
2449,2671,666,683,15,14,4,111,2,421,0,686,0,2602,11,52,1,1,4,69
2450,50381,17406,11460,330,174,184,2412,67,7290,4,9481,6,48814,97,981,169,28,292,1567
2452,14005,5421,3168,95,60,55,603,17,1829,0,2557,0,13805,34,140,8,0,18,200
2453,3885,843,916,16,5,1,172,1,728,0,992,0,3674,13,134,18,0,46,211
2454,9241,2493,2483,62,40,32,435,16,1237,3,2169,0,8970,29,140,43,8,51,271
2455,3931,1206,846,18,14,23,199,3,515,1,1043,0,3868,2,38,5,0,18,63
2456,17661,6020,4262,139,74,78,734,23,2501,0,3532,0,17363,37,174,37,0,50,298
2460,37229,10130,8064,165,132,106,1249,18,5389,9,10492,2,35756,72,758,212,31,400,1473
2462,3787,775,860,11,15,14,131,2,624,0,1237,0,3669,12,78,6,1,21,118
2463,10118,2775,2204,42,32,31,315,3,1383,5,3024,0,9814,14,183,30,5,72,304
2464,7008,2446,1711,46,31,30,196,13,867,1,1599,3,6943,25,33,1,4,2,65
2465,484,121,87,1,4,2,11,1,77,0,170,0,474,0,6,0,1,3,10
2466,2079,538,515,9,6,10,59,2,306,0,607,0,2052,0,26,1,0,0,27
2469,5542,1109,1385,12,19,19,172,1,1025,0,1617,0,5359,5,150,6,0,22,183
2470,17271,4868,3598,78,59,72,468,10,2789,4,4439,0,16385,37,416,129,2,302,886
2471,3247,729,804,8,4,7,112,4,493,0,968,1,3130,0,68,16,1,32,117
2472,2584,618,540,6,4,5,92,4,436,1,733,0,2439,0,51,35,4,55,145
2473,3313,1091,795,20,11,19,101,9,456,0,781,0,3283,0,24,1,0,5,30
2474,7816,1826,1925,28,29,21,299,7,1391,9,1907,0,7442,14,240,19,34,67,374
2475,436,96,104,1,2,1,8,0,66,1,120,0,399,1,22,5,0,9,37
2476,728,159,180,3,3,3,27,0,126,0,168,0,669,4,36,7,1,11,59
2477,13668,4911,3007,72,34,50,488,13,1872,1,2904,0,13352,25,195,32,0,64,316
2478,31224,12354,7254,218,94,188,1140,60,4079,1,5176,1,30565,114,425,33,18,69,659
2479,6127,2081,1654,75,23,16,270,15,876,0,973,0,5983,13,109,3,1,18,144
2480,49108,17235,11216,303,161,121,1664,38,7357,12,9450,3,47560,147,843,177,17,364,1548
2481,13731,5015,3755,203,120,81,713,106,1886,2,1588,1,13470,46,173,8,1,33,261
2482,7739,2487,2237,58,46,42,342,17,1140,1,1233,1,7604,24,96,2,1,12,135
2483,11268,4092,2961,103,60,60,438,25,1548,3,1835,0,11125,5,119,4,2,13,143
2484,20818,6747,4882,117,73,57,849,22,3095,4,4068,0,19914,81,528,99,8,188,904
2485,10023,5225,1991,59,32,37,319,18,1160,2,1053,0,9896,66,53,2,0,6,127
2486,25662,12240,5483,155,72,94,827,46,2992,0,3535,0,25444,22,163,18,2,13,218
2487,11684,5155,2676,82,38,53,396,33,1495,0,1513,0,11441,1,182,10,2,48,243
2488,2666,1038,672,19,11,14,89,7,381,0,411,0,2642,0,23,0,0,1,24
2489,5959,2569,1439,47,14,38,191,10,727,0,873,0,5908,1,34,2,2,12,51
2490,668,223,142,5,0,1,29,0,108,0,147,0,655,0,10,1,0,2,13
2500,33674,18621,6648,268,142,66,1337,100,3590,6,2424,0,33202,39,319,28,8,78,472
2502,9440,4723,1793,106,33,38,384,14,1031,0,1148,0,9270,1,67,11,2,89,170
2505,5497,2093,1031,47,37,16,166,7,945,2,566,0,4910,2,208,116,23,238,587
2506,6333,3079,1189,64,9,22,297,7,741,0,888,1,6297,3,26,2,1,4,36
2508,8892,3277,2192,63,38,23,461,13,1173,1,1439,0,8680,5,121,15,4,67,212
2515,9863,4326,2478,128,28,37,455,44,1071,0,1244,0,9811,0,47,1,0,4,52
2516,5660,2433,1315,77,22,24,258,18,722,0,761,0,5630,0,29,0,0,1,30
2517,11552,5288,2529,108,26,35,547,33,1373,0,1491,0,11430,1,97,7,0,17,122
2518,16211,7625,3464,156,36,44,775,49,1885,1,2000,0,16035,21,123,10,2,20,176
2519,14358,7137,3000,138,71,33,654,54,1566,4,1450,0,14107,26,169,20,1,35,251
2525,9935,5062,2155,70,19,18,415,7,985,0,1152,0,9883,3,39,4,0,6,52
2526,19301,7729,3707,143,51,29,777,13,3105,3,2365,0,17922,7,714,161,73,424,1379
2527,26732,10903,5337,152,64,81,1405,26,3674,0,4258,0,25900,42,422,96,4,268,832
2528,21287,9492,4283,183,93,84,942,38,2625,1,3357,0,21098,56,116,5,0,12,189
2529,28270,12360,5887,170,110,85,1295,44,3616,2,4062,3,27634,25,353,70,8,180,636
2530,31790,14318,6422,205,66,92,1576,38,3850,0,5001,1,31569,4,166,18,5,28,221
2533,18026,7136,3982,116,56,125,766,29,2245,3,3119,0,17577,59,270,29,5,86,449
2534,6284,2349,1367,51,25,19,247,10,857,0,1209,0,6134,10,88,11,0,41,150
2535,9738,3186,2135,58,26,36,330,19,1427,3,2355,0,9575,3,124,11,2,23,163
2536,23149,7726,4721,92,55,107,1031,26,3194,3,5670,2,22627,44,356,36,6,80,522
2537,18009,5019,3651,73,68,73,825,22,2543,0,5204,0,17478,46,354,23,3,105,531
2538,3555,895,857,26,7,12,177,5,537,1,939,0,3456,4,77,4,2,12,99
2539,25205,7592,5789,140,96,111,1121,46,3613,1,6248,2,24759,48,288,39,3,68,446
2540,60129,18496,11912,276,207,245,2940,93,8109,8,16894,2,59182,51,639,74,16,167,947
2541,32713,11301,6259,206,120,88,1535,39,4860,4,6554,1,30967,364,721,222,26,413,1746
2545,1843,381,416,10,4,5,90,3,310,0,553,0,1772,0,45,6,1,19,71
2546,12765,3574,2805,54,37,51,511,22,1817,0,3641,0,12512,19,159,19,12,44,253
2548,9042,3337,2016,41,13,34,310,13,1239,0,1966,1,8970,1,44,9,0,18,72
2549,5893,1386,1213,20,15,25,221,10,1092,0,1640,0,5622,41,149,9,3,69,271
2550,23862,5592,5190,105,71,67,987,13,4054,3,6966,0,23048,36,492,66,19,201,814
2551,4581,1178,912,11,10,22,167,3,818,0,1294,0,4415,4,89,24,3,46,166
2555,189,48,34,2,0,0,4,0,31,0,43,0,162,0,12,7,0,8,27
2556,3574,1004,654,18,3,8,149,3,536,0,717,0,3092,1,202,68,23,188,482
2557,16309,7900,3599,102,28,35,525,5,1997,0,1512,0,15703,3,385,71,3,144,606
2558,8554,4336,1882,79,18,19,353,3,829,0,959,0,8478,0,53,7,0,16,76
2559,1350,760,338,34,2,9,37,0,90,0,78,0,1348,0,2,0,0,0,2
2560,61210,31197,13040,672,209,160,2399,28,6175,2,6354,1,60237,188,439,69,8,269,973
2563,269,84,49,2,1,0,7,0,43,0,71,0,257,0,7,0,0,5,12
2564,8587,4738,1930,125,30,28,278,3,624,0,685,0,8441,108,30,2,0,6,146
2565,24693,12320,5460,226,55,44,610,12,2903,0,1617,0,23247,12,618,155,5,656,1446
2566,21921,10525,4907,203,67,51,634,10,2400,2,2028,1,20828,16,358,130,6,583,1093
2567,37858,17042,7796,230,52,44,1509,14,5424,2,4646,1,36760,136,584,116,14,248,1098
2568,1443,450,317,12,3,2,54,1,209,0,325,0,1373,3,31,12,0,24,70
2569,1957,563,335,11,4,5,120,3,312,1,539,0,1893,0,39,7,1,17,64
2570,60137,24999,12744,270,91,94,2606,23,8010,8,8718,2,57565,56,1289,460,25,742,2572
2571,16544,5201,3205,68,59,27,901,3,2724,0,3464,1,15653,45,429,187,9,221,891
2572,6286,2075,1273,25,8,13,316,4,960,0,1386,0,6060,3,135,22,1,65,226
2573,5808,2156,1126,35,11,11,285,2,898,0,1163,1,5688,5,66,16,2,31,120
2574,7970,2313,1426,45,13,28,389,3,1216,1,1994,0,7428,7,223,100,0,212,542
2575,22060,7580,4383,121,67,40,1027,18,3480,3,4293,0,21012,91,503,190,13,251,1048
2576,14561,6918,3181,74,28,31,444,21,1551,0,2131,1,14380,2,132,20,2,25,181
2577,21420,6847,4442,105,55,39,833,23,3474,4,4599,0,20421,35,581,127,6,250,999
2578,3260,1279,667,17,5,9,142,2,404,1,703,0,3229,0,25,1,0,5,31
2579,7205,1830,1366,32,13,11,285,5,1326,0,1916,0,6784,10,200,72,4,135,421
2580,39900,12356,7037,188,100,76,1522,38,7442,10,8981,1,37751,107,1092,309,14,627,2149
2581,3796,835,776,11,8,3,122,1,705,1,1076,0,3538,2,157,25,2,72,258
2582,18302,4949,3619,71,34,30,593,18,2897,9,5250,2,17472,38,551,51,15,175,830
2583,7464,1575,1460,19,25,12,247,2,1586,4,2142,0,7072,32,246,32,2,80,392
2584,927,195,185,1,1,2,32,4,164,0,293,0,877,1,26,4,0,19,50
2585,462,101,115,2,0,0,17,0,84,0,108,0,427,0,20,6,0,9,35
2586,4682,849,975,9,5,2,128,2,872,1,1565,0,4408,11,168,28,4,63,274
2587,4680,929,885,14,12,8,136,4,822,4,1448,0,4262,14,152,75,8,169,418
2588,630,97,144,1,1,1,22,0,117,0,201,0,584,0,20,9,0,17,46
2590,9803,2381,1875,31,44,29,308,12,1562,4,2829,2,9077,19,274,168,10,255,726
2594,17008,4059,3581,85,47,39,590,9,3080,2,4470,1,15963,26,557,139,4,319,1045
2618,1545,309,349,5,2,6,61,0,270,0,359,0,1361,0,112,23,1,48,184
2619,8782,4219,1688,46,2,12,390,8,960,0,1387,1,8713,0,58,1,1,9,69
2620,47454,17859,8837,191,63,65,1981,40,7344,11,9056,1,45448,144,1334,120,41,367,2006
2621,8972,2391,1780,34,9,13,414,5,1465,6,2534,0,8651,9,259,11,2,40,321
2622,7018,1290,1675,20,26,14,281,6,1290,0,2072,0,6674,17,242,23,2,60,344
2623,768,151,196,2,3,1,40,0,155,0,201,0,749,0,16,1,0,2,19
2625,356,89,103,1,3,2,17,2,65,0,53,0,335,14,7,0,0,0,21
2626,742,134,140,2,0,1,37,0,159,0,233,0,706,0,32,0,0,4,36
2627,7317,1292,2149,27,39,18,260,11,1318,1,2015,0,7130,22,138,2,6,19,187
2628,3437,568,855,10,11,7,129,4,627,0,1064,0,3275,17,101,13,6,25,162
2629,905,107,222,2,3,2,24,0,144,0,323,0,827,3,43,8,2,22,78
2630,12470,2771,3001,37,39,14,426,5,2328,7,3150,0,11778,77,372,81,25,137,692
2631,989,135,267,2,4,1,37,1,217,0,285,0,949,0,30,5,0,5,40
2632,2872,479,626,8,9,3,94,0,622,0,839,0,2680,8,87,23,1,73,192
2633,508,98,115,0,3,0,18,0,108,0,149,0,491,2,11,0,0,4,17
2640,36870,14697,7245,163,122,72,1252,49,5569,4,6708,3,35884,84,456,95,4,347,986
2641,14863,6290,2646,82,67,19,630,17,2053,1,2778,0,14583,5,119,27,2,127,280
2642,7297,1613,1377,33,18,9,246,3,1402,1,2124,1,6827,9,190,84,3,184,470
2643,3311,996,593,6,13,10,80,1,579,1,956,0,3235,0,40,11,0,25,76
2644,3635,797,712,9,7,4,102,1,712,1,1099,0,3444,7,110,19,4,51,191
2645,695,137,119,2,3,2,15,0,138,0,208,0,624,0,28,17,0,26,71
2646,8334,2340,1512,23,15,13,213,5,1417,13,2126,1,7678,33,142,135,11,335,656
2647,2099,638,478,7,8,8,63,2,379,2,451,0,2036,2,18,12,1,30,63
2648,2908,496,680,6,7,4,89,2,639,5,853,0,2781,5,73,10,8,31,127
2649,51,7,11,0,0,1,2,0,12,0,18,0,51,0,0,0,0,0,0
2650,67089,22477,12936,364,199,104,2257,38,11096,13,14610,3,64097,92,1410,427,53,1010,2992
2651,2359,803,441,6,2,5,152,2,389,0,540,0,2340,0,13,1,0,5,19
2652,8286,1476,1511,25,20,8,212,0,1556,6,2641,0,7455,13,298,165,18,337,831
2653,3733,616,798,11,11,6,82,2,723,0,1209,0,3458,11,111,46,7,100,275
2655,2171,445,367,13,6,5,72,0,399,1,733,0,2041,15,58,17,0,40,130
2656,1919,374,296,7,1,2,55,0,380,0,562,0,1677,6,82,54,0,100,242
2658,2086,475,368,12,3,5,49,1,345,0,603,1,1862,16,65,45,1,97,224
2659,1279,295,223,1,6,0,42,0,261,0,343,0,1171,11,51,14,2,30,108
2660,2258,563,385,9,4,2,72,1,407,1,660,0,2104,14,78,21,0,41,154
2661,125,36,24,0,0,0,8,0,32,0,23,0,123,0,2,0,0,0,2
2663,5562,1527,954,29,15,15,191,2,949,0,1616,1,5299,12,119,45,1,86,263
2665,3594,593,670,17,4,4,106,0,672,1,1050,0,3117,9,111,134,0,223,477
2666,8239,1743,1394,26,18,15,285,5,1515,5,2500,0,7506,17,255,155,15,291,733
2668,798,121,155,0,2,3,31,0,124,0,229,0,665,1,26,41,0,65,133
2669,2840,407,673,6,8,4,59,0,504,0,833,0,2494,6,79,94,3,164,346
2671,6013,1133,1324,15,17,9,213,4,970,1,1809,0,5495,34,179,74,9,222,518
2672,2084,348,494,5,13,0,32,1,374,2,666,0,1935,6,60,29,1,53,149
2675,2160,309,532,4,5,1,46,0,400,1,620,0,1918,4,49,59,0,130,242
2678,22,12,3,0,0,0,1,0,5,0,1,0,22,0,0,0,0,0,0
2680,29178,9354,5494,209,100,45,1092,32,5292,10,5169,0,26797,83,781,466,26,1025,2381
2681,2621,592,491,7,2,4,104,0,606,0,586,0,2392,0,70,51,1,107,229
2700,6497,1645,1101,23,20,11,190,2,1229,3,1832,0,6056,17,191,69,17,147,441
2701,3558,769,627,10,7,14,97,3,603,0,1178,0,3308,26,109,40,0,75,250
2702,1167,275,211,6,4,2,20,0,209,0,351,0,1078,3,35,24,0,27,89
2703,1022,255,197,3,1,1,38,0,178,0,302,0,975,5,20,9,0,13,47
2705,13467,3608,2401,59,25,23,481,9,2567,5,3337,0,12515,30,324,187,19,392,952
2706,1698,352,378,9,7,2,56,0,291,0,467,0,1562,1,29,30,2,74,136
2707,2400,346,486,4,9,4,75,0,416,0,657,1,1998,1,87,98,0,216,402
2710,13421,2837,2741,39,33,14,314,8,2504,10,3711,0,12211,58,330,210,29,583,1210
2711,4879,806,1028,11,13,4,184,7,914,4,1604,0,4575,8,121,38,7,130,304
2712,2052,416,338,5,1,2,51,2,373,0,521,0,1709,0,58,95,3,187,343
2713,3606,832,704,12,5,2,118,5,602,1,864,1,3146,1,78,103,2,276,460
2714,2864,845,615,8,8,7,88,0,522,0,671,0,2764,20,32,17,0,31,100
2715,2260,395,474,6,6,3,35,0,417,3,663,0,2002,12,46,51,2,147,258
2716,1756,306,322,6,6,2,28,2,345,5,519,0,1541,3,47,41,13,111,215
2717,1089,309,210,5,6,0,31,0,236,1,256,0,1054,8,10,5,1,11,35
2720,11746,2698,2580,55,49,26,399,4,1832,9,3335,1,10988,23,314,105,12,304,758
2721,366,61,81,1,1,2,9,0,63,0,111,0,329,1,13,9,2,12,37
2722,4422,987,902,7,8,8,99,1,816,1,1317,0,4146,25,151,32,3,65,276
2725,674,113,123,3,3,0,28,0,127,0,226,0,623,0,16,13,0,22,51
2726,545,73,97,4,1,0,12,0,102,0,136,0,425,0,33,27,1,59,120
2727,668,68,175,0,2,1,10,0,152,0,200,0,608,1,44,3,0,12,60
2729,2745,497,583,6,4,2,78,1,501,0,916,0,2588,1,91,20,1,44,157
2730,1978,429,464,3,6,4,59,0,386,0,563,0,1914,3,49,6,0,6,64
2731,4453,1687,1066,17,11,15,81,7,706,2,738,0,4330,7,45,22,0,49,123
2732,1951,454,393,4,5,3,55,0,367,1,568,0,1850,15,26,20,1,39,101
2733,969,115,233,1,3,0,12,1,172,2,272,0,811,4,35,36,3,80,158
2735,232,60,53,1,0,1,11,0,46,0,47,0,219,1,2,5,0,5,13
2736,277,68,70,3,2,0,4,0,62,0,61,0,270,1,1,2,0,3,7
2737,586,135,158,1,3,1,6,0,146,1,120,0,571,5,5,2,0,3,15
2738,1728,471,410,7,3,0,49,2,391,0,369,0,1702,0,13,5,2,6,26
2739,1018,309,219,5,1,0,29,0,226,0,202,0,991,2,8,3,0,14,27
2745,27595,12684,5612,174,47,54,1066,16,3405,1,3767,1,26827,12,481,75,9,191,768
2747,39232,19684,8280,302,93,76,1418,16,4133,8,4295,0,38305,14,525,113,11,264,927
2748,2854,982,486,16,10,4,87,2,377,0,597,0,2561,3,173,23,5,89,293
2749,15100,6369,3043,106,28,33,655,8,1911,1,2412,0,14566,16,320,63,7,128,534
2750,44837,21599,8607,263,119,79,1662,30,6113,15,4941,0,43428,146,729,122,35,377,1409
2752,7392,2536,1393,29,10,12,372,6,1200,0,1502,0,7060,2,260,19,4,47,332
2753,19700,6628,3982,102,34,53,886,8,2760,11,4332,0,18796,6,552,66,17,263,904
2754,7736,2882,1673,29,14,22,349,7,1006,2,1512,0,7496,2,143,28,7,60,240
2756,43712,13096,9100,193,103,80,2047,16,6889,18,9558,1,41101,137,1431,292,34,717,2611
2757,1244,353,260,9,2,2,72,0,178,0,311,0,1187,2,33,8,0,14,57
2758,12806,3574,2602,62,10,18,713,6,2006,1,3290,0,12282,17,353,43,4,107,524
2759,24155,10815,4693,168,36,35,868,10,2836,0,2726,0,22187,3,719,458,1,787,1968
2760,27687,13746,5598,284,81,77,841,7,3140,2,2872,7,26655,83,607,100,41,201,1032
2761,26484,12904,6090,352,69,72,625,5,2591,2,2132,0,24842,152,806,172,103,409,1642
2762,13054,7464,3495,116,16,18,389,3,854,0,553,0,12908,0,83,26,0,37,146
2763,21543,12264,5022,221,21,44,705,11,1568,0,1549,0,21405,3,96,20,1,18,138
2765,39141,17733,9260,300,57,59,1139,14,4290,4,4263,1,37120,21,1037,296,40,627,2021
2766,14867,6048,2774,161,42,34,299,7,1633,0,2223,0,13221,6,685,200,8,747,1646
2767,14515,8461,3477,220,35,27,341,5,931,0,848,0,14345,1,82,35,3,49,170
2768,17746,10530,4406,218,25,25,494,7,1088,0,796,0,17589,0,73,41,0,43,157
2769,9708,5623,2703,85,16,17,242,3,589,0,379,0,9657,1,38,8,0,4,51
2770,39737,20220,8621,644,240,176,1074,11,3760,4,3535,0,38285,17,635,186,1,613,1452
2773,5460,2603,1203,30,6,17,240,4,499,0,808,1,5411,0,42,3,0,4,49
2774,11496,5325,2471,90,13,26,520,8,1168,0,1797,0,11418,2,63,9,0,4,78
2775,2464,549,560,13,7,5,118,1,406,1,698,0,2358,7,73,6,2,18,106
2776,3887,1730,850,40,5,7,189,3,403,0,639,0,3866,2,14,4,0,1,21
2777,16962,7456,3613,160,36,43,840,13,1710,0,2784,1,16656,101,156,15,3,31,306
2778,2452,1063,554,18,3,8,128,1,217,2,446,0,2440,4,8,0,0,0,12
2779,4453,2085,931,48,10,16,236,2,437,0,678,0,4443,3,7,0,0,0,10
2780,11490,5506,2382,104,52,34,461,22,1301,3,1444,0,11309,17,146,5,2,11,181
2782,5538,2669,1228,51,12,19,183,6,526,0,798,0,5492,4,34,0,1,7,46
2783,2630,1156,543,18,12,5,136,2,323,0,390,0,2585,10,33,2,0,0,45
2784,1272,541,269,13,1,2,68,0,153,0,219,0,1266,0,6,0,0,0,6
2785,4356,1929,1028,23,17,18,152,4,513,1,624,0,4309,1,39,0,2,5,47
2786,1316,470,296,8,14,4,65,1,192,0,252,0,1302,0,11,1,0,2,14
2787,6878,1379,1570,20,16,10,322,7,1255,5,1647,0,6231,44,245,136,21,201,647
2790,18694,5726,3723,87,49,39,987,11,3129,3,4157,0,17911,47,442,71,38,185,783
2791,470,107,106,1,2,1,13,0,96,0,133,0,459,1,8,1,1,0,11
2792,572,118,118,2,1,1,21,0,123,0,172,0,556,0,15,0,0,1,16
2793,1768,338,351,10,4,3,60,0,360,0,561,0,1687,1,47,12,0,21,81
2794,13734,3554,2686,51,33,20,502,8,2360,2,3694,1,12911,30,340,142,5,306,823
2795,51983,16772,10011,239,111,84,2392,35,9104,23,11076,2,49849,121,1155,286,37,535,2134
2797,731,131,141,4,1,5,34,0,136,0,252,0,704,2,17,3,0,5,27
2798,3119,725,643,10,1,6,121,3,560,0,887,0,2956,0,97,19,1,46,163
2799,5852,1459,1019,27,7,6,244,6,1190,3,1555,1,5517,20,183,34,13,85,335
2800,54060,17215,11078,306,182,73,2131,21,8999,19,11153,1,51178,105,1257,421,33,1066,2882
2803,585,68,128,3,1,1,31,0,105,0,182,0,519,0,28,11,0,27,66
2804,4115,836,801,14,13,5,161,1,734,2,1259,0,3826,6,123,45,0,115,289
2805,882,129,182,3,1,2,16,0,164,0,243,0,740,1,38,30,0,73,142
2806,1300,239,274,3,6,5,49,0,269,1,365,0,1211,3,45,15,0,26,89
2807,821,156,129,3,0,4,61,0,150,0,270,0,773,0,18,10,0,20,48
2808,342,50,75,2,0,0,21,0,73,1,104,0,326,0,14,1,0,1,16
2809,375,73,81,0,0,3,9,0,83,0,106,0,355,0,15,2,0,3,20
2810,4917,1077,872,12,11,8,165,1,851,2,1426,0,4425,23,159,97,10,203,492
2820,8143,1915,1725,46,14,10,326,7,1359,3,2351,1,7757,26,198,48,5,109,386
2821,6584,1322,1374,25,12,6,186,3,1122,4,1866,0,5920,15,197,125,9,318,664
2823,2209,348,512,7,8,3,43,2,343,0,620,0,1886,8,58,72,2,183,323
2824,3400,458,1017,5,10,3,57,2,513,2,964,0,3031,5,97,65,2,200,369
2825,3378,608,801,17,8,1,86,3,575,3,997,0,3099,12,117,56,1,93,279
2827,4940,1001,1152,13,14,9,135,2,756,5,1430,0,4517,10,143,72,16,182,423
2828,1072,154,239,1,2,1,29,0,208,1,305,0,940,1,49,29,1,52,132
2829,4173,684,1043,22,13,1,79,4,686,3,1206,2,3743,17,151,68,4,190,430
2830,52400,15609,10936,242,188,81,1770,37,8625,30,11706,2,49226,139,1520,427,65,1023,3174
2831,5054,785,1154,21,16,10,131,3,976,0,1494,0,4590,9,217,72,1,165,464
2832,3118,461,775,15,9,3,48,1,541,8,819,1,2681,6,117,74,18,222,437
2833,1032,123,275,0,5,0,12,0,177,0,266,0,858,7,21,33,1,112,174
2834,2795,550,689,13,19,8,62,2,553,2,746,0,2644,11,89,17,6,28,151
2835,5000,796,1199,12,9,6,146,4,992,9,1430,0,4603,5,131,58,10,193,397
2836,787,96,220,4,1,1,11,0,147,3,232,0,715,4,33,12,2,21,72
2839,1126,189,320,9,8,0,28,1,186,0,252,1,994,3,35,17,6,71,132
2840,2933,456,797,11,12,1,51,0,544,3,762,0,2637,11,114,38,15,118,296
2842,1194,235,242,4,3,1,21,0,258,1,338,0,1103,3,63,10,0,15,91
2843,1898,296,479,9,4,3,57,1,335,1,575,0,1760,7,91,15,0,25,138
2844,1953,362,442,2,5,2,65,2,355,1,567,0,1803,8,105,10,0,27,150
2845,2627,710,524,13,14,4,168,1,488,0,621,0,2543,2,58,4,0,20,84
2846,555,98,128,1,1,1,31,1,110,0,164,0,535,0,15,3,0,2,20
2847,3317,867,612,18,6,5,161,2,655,0,937,0,3263,0,46,2,2,4,54
2848,2082,587,423,6,4,7,97,2,369,0,549,0,2044,3,31,0,1,3,38
2849,2688,476,670,4,8,3,97,2,530,1,789,0,2580,4,78,11,1,14,108
2850,25990,5732,6040,109,129,31,1234,17,5073,1,6526,1,24893,51,702,106,24,214,1097
2852,5356,1060,1175,12,12,7,182,2,985,1,1582,0,5018,18,172,49,1,98,338
2864,1394,243,274,2,5,1,57,0,266,0,436,0,1284,15,38,23,1,33,110
2865,1414,254,300,6,4,2,52,3,276,0,416,0,1313,0,52,15,2,32,101
2866,4358,867,1011,11,5,11,166,1,777,0,1226,0,4075,11,161,40,1,70,283
2867,868,150,200,1,2,2,19,0,170,0,274,0,818,5,28,5,0,12,50
2868,1019,171,224,4,4,1,20,1,190,1,306,0,922,0,35,16,0,46,97
2869,2033,446,403,7,3,4,63,5,400,0,552,0,1883,5,56,27,0,62,150
2870,15239,3809,2992,62,29,19,600,8,2763,7,3971,0,14260,55,404,152,16,352,979
2871,12602,2652,2607,51,19,17,344,5,2457,3,3486,0,11641,20,392,173,16,360,961
2873,1140,137,282,1,2,2,37,0,216,1,344,0,1022,0,53,24,1,40,118
2874,619,92,156,2,1,0,16,0,109,0,183,0,559,2,25,12,0,21,60
2875,1371,198,306,7,4,1,41,0,248,0,407,0,1212,12,47,26,0,74,159
2876,784,133,137,3,2,0,27,0,156,0,225,0,683,0,41,24,0,36,101
2877,4907,880,1238,28,22,9,74,1,951,3,1309,0,4515,15,136,64,5,172,392
2878,458,39,131,0,1,0,4,0,98,0,126,0,399,1,21,11,1,25,59
2879,673,109,173,1,2,0,10,0,139,0,214,0,648,0,17,0,0,8,25
2880,19171,5288,4063,72,47,24,797,27,3467,8,4620,1,18414,27,306,100,15,309,757
2898,308,63,78,7,11,0,15,1,57,1,70,0,303,0,3,0,2,0,5
Interstate/Unknown,14314,4344,2581,50,72,27,302,9,2636,2,2685,2,12710,33,609,188,13,761,1604
TOTAL,7019899,3043513,1525105,53334,19372,16346,260035,11873,862695,994,1016929,168,6810364,13415,110006,25270,3182,57662,209535
